%%%%%%%%%%%%%
%         o %
%  .        %
%           %
%  %%       %
%     %     %
%   %       %
%     P     %
%%%%%%%%%%%%%
